+--+--+--+--+--+
|     |        |
+  +  +  +  +  +
|  |  |        |
+  +--+  +--+  +
|     |        |
+--+  +  +  +  +
|     |  |     |
+  +--+  +  g  +
|        |     |
+--+--+--+--+**+
