+--+--+--+--+--+
|              |
+  +--+  +  +  +
|  |     |     |
+  +  +  +--+  +
|     |        |
+--+  +  +  +  +
|     |  |     |
+  +  +  +  g  +
|        |     |
+--+--+--+--+**+
