+--+--+--+--+--+
|              |
+  +--+--+     +
|  |          *|
+  +--+  +--+  +
|     |        *|
+--+  +--+  +  +
|     |  |     *|
+  +--+  +  g  +
|        |     |
+--+--+--+--+**+
